11111111111111111111111111111111111111
100000000000000000000000000000000000P1
10000000F00000000000F00000000000000001
10000000000000000000000000000000000001
10000000C00000000000000000000000000001
10000000000111100000000000000000000001
10000011111000010000000000000100000001
100000000000C0001000000000000010000001
10000000000000001000000000000001000001
11111111111111111000000000000000100001
1E010000000000000000000000000000110001
10010C00001000000000000000000001001001
100100000100000000000000000000100001C1
111111111F0000000000000000000100CC0011
1C100010000000000000000F00001000000001
10101010100000000000000000010000000001
10101010100000000000000000000000000001
10101010100000000000F00000000000000001
10001000100000000000000000000000000001
11111111111111111111111111111111111111
