1111111
100F001
1P0C0E1
1000001
1111111
