111111111
100000001
100000C01
1000P0001
10E000001
100000001
111101111