111111111
100000001
100000C01
1000P0001
10E00000
100000001
111111111