111111111
100001001
100C01C01
1000P1111
10E000001
10000C001
111111111