111111111
100000C01
100000C01
1000P0001
10000C001
1000000C1
111111111