111111111
100000001
100C00C01
1000P0001
10E000001
10000C001
111111111